11111111111111111111111111111111111111
10000000110000000000000000011000000011
10100000111000000000000000011000000011
10000000000000000000000000011000011011
11111110110000011100000000011000000011
10000000110000011101110000000000000011
11111111111010100000010000011000000011
11111111111101110101000000011000000011
11000011010101110000000000011000011011
10000000000000000000000000011000000011
11111111111101110101000000000000000011
10000000000000000000000000011000000011
11111111111101110101000000000000000011
11111111111101110101000000000000000011
10000000000000000000000000011000000011
10000000000000000000000000011111000011
10000P00000000110101000000011111000011
11000111010101111101110000011000000011
11111101110101010111100000011000000011
11111111111111111111111111111111111111