1111111111111111111111111111111
1000000000000000000000000000001
1000000000000000000000000000001
1000000000000000111111111000001
1111111111111111110000000000001
1000000000000000000000111111111
1000000111111110000000000001111
1000000000000111111111111111111
1000000000000000000000000000001
1111111000000011111111110000001
1000000000000000000000000000001
1111111110000001100000000000111
1000000000001100000000000000111
11111111111110000000P0000001111
1111111111110000000000000111111
1111111111111111111111111111111